11111111111111111111111111111
10000000001000011000010010001
100000001001100001000000E1001
1000C0000101C1000000010010001
10000000010000000010011P00001
10010000011100000000010000101
100000000C00C0011100010000001
11110001000000010000010000001
11111111111111111111111111111