11111111111111111111111111111
10000000001000011000010000001
10000000100100000100010000001
1000C000010000000000010000001
10000000010000000000010P00001
10010000011100000000010000E01
100000000C00C0011100000000001
11110001000000010000010000001
11111111111111111111111111111