1111111111111111111111111111111111111111111111111111
1000000000000000000000000000000000000000000000000001
1000000001000000000000100000000000000000000000000001
1000000000000001000000000000000000000000000000000001
1000000000000000000000000000000000000000000000000001
100000000000000000C000000001000000000000000000000001
100000000000C000000000000000000000000000000000000001
1000000000000001000000C00000000000000000000000000001
10000000P0000000000000000000000000000000000000000001
1000000000000000000000000000000000000000000000000001
1000000000000000000111000000E00000000000000000000001
1000000000000000000000000000000000000000000000000001
1000000000000000000000000000000000000000000000000001
1111111111111111111111111111111111111111111111111111