111111111111111111111111111111111
100C00000010000110000000000000001
100000001001000001000000000000001
1000000001000000C0000000000000001
10000000010000000000000000C000001
100100000111000P0000000000E000001
1000000000000C0111000000000000001
111100010000000100000000000000001
111111111111111111111111111111111