11111111111111111111111111111
10000000001000011000010000001
10000000100110000100000000001
1000C0000101C10N0000010000001
1000000001E000000010011P00001
10010000011100000000010000101
100000000C00C0011100010000001
11110001000N0001000001000N001
11111111111111111111111111111