11111111111111111111111111111
10000000001000011000010000001
10000000100100000100010000001
1000C0000100000N0000010000001
10000000010000000000010P00001
10010000011100000000010000E01
100000000C00C0011100000000001
11110001000N0001000001000N001
11111111111111111111111111111