111111111111
10N0P00E00C1
111111111111