111111111111
1C0P1E011111
111111111111