111111111111
1000000E0001
1C00000P0001
1C0000000001
1C0000000001
1C0000000001
1C0000000001
111111111111